......@@......@@..........
......@@......@@..........
..##..@@......##......##..
..##..@@......##......##..
..##..........##..##%%##..
..##........####..##%%##..
..................@@......
..................@@......
%%....##....@@....##%%##@@
%%....##....@@....##%%##@@
%%%%............@@..%%....
%%%%............@@..%%....
..######%%%%%%@@....%%##..
..######%%%%%%@@....%%##..
......@@%%##..##..##..##..
......@@%%##..##..##..##..
@@##..@@..##..##......##..
@@##..@@..##..##......##..
..##..##..######..##..##..
..##..##..######..##..##..
..##..##..######..........
..##..##..................
..##..............##..##..
..##.......####...##..##..
..##..##...#C.#...######..
..##..##...#..#...######..
